7777777777777777777777777777777777777777
7000000007111111111111111111111111111747
7000000007100000000000000000000000000007
7000000007100000000000000000000011110007
7777000777100000000111111111111111111707
7111000111100000000111111111111111111707
7100000000000000000111111111111111111707
7100000000000400000111111111111111111707
7100000000000000000111111111111111111707
7100000000000000000111111111111111111747
7100000000000000000111111111111133333307
7111000111111111111111111111111130000007
7222000222222222222233333333333330000037
7200000000000040000230000000000000000037
7200000000000000400230000400004000040037
7200000000000040000230000000000000000037
7222222222222222222233333330000003333337
7777777777777777777777777770000007777777
7000000400000000000070000000000000000007
7077777777777777770470000000000000000007
7077777777777777770077777777777777770007
7077777777777777770000040000000000000007
7077777777777777777777777777777777777777
7000000000755555555555555555555555555557
7000040000750000000000000000000000000057
7004000400000000777777777740000000000057
7000040000000000777777777700000000000057
7000000000750000000000000000000000000057
7000000000755555555555555555555555555557
7777777777777777777777777777777777777777
