7777777777777777777777777777777777777777
7007600000032040000000000000000000000007
7007600000432000000000000040000000000007
7007600650032001777777777700777777777007
7007600650032001777777777700777777777007
7007604650032001777777777700777777777007
7007600650032001777777777700777777777007
7047600650032001777777777700777777777007
7007600650032401777777777700777777777007
7007600650032001777777777700777777777007
7007600650032001777777777700777777777007
7007600654032001777777777700777777777407
7007600650032001777777777700777777777007
7007640650032001777777777700777777777007
7007600650032001777777777700777777777007
7407600650032041777777777700777777777007
7007600650032001777777777700777777777007
7007600650032001777777777700777777777007
7007600650032001777777777700777777777007
7007600650432001777777777700777777777007
7007604650032001777777777700777777777007
7007600650032001777777777700744447777007
7007600650032001777777777700744447777007
7007600650032401777777777700744447777007
7047600650032001777777777700744440000007
7007600650032001777777777700777777777777
7007600650032001777777777700777777777777
7000000650040001777777777700000000000007
7000000650000001777777777700000000000007
7777777777777777777777777777777777777777
