7777777777777777777777777777777777777777
7000007000007000007000007000007000007777
7000007000007000007000007000007000007777
7000000004000004000004007004000004007777
7000007000007000007000007000007000007777
7000007000007000007000007000007000007777
7770777770777777777770777777777770777777
7660666660666666666660666666666660666667
7000006000006000006000006000006000006667
7000006000006000006000006000006000006667
7004000004000004006004000004000004006667
7000006000006000006000006000006000006667
7000006000006000006000006000006000006667
7666666660666666666660666666666666666667
7555555550555555555550555555555555555557
7000005000005000005000005000005000005557
7000005000005000005000005000005000005557
7004000004005004000004005004005004005557
7000005000005000005000005000005000005557
7000005000005000005000005000005000005557
7550555555555550555555555555555555555557
7330333333333330333333333333333333333337
7300003000003000003000003000003000000037
7300003000003000003000003000003000000037
7300003000003000003000003000003000000037
7304000004003004000004000004000000400037
7300003000003000003000003000003000000037
7300003000003000003000003000003000000037
7333333333333333333333333333333333333337
7777777777777777777777777777777777777777
