7777777777777777777777777777777777777777
7000000000000000000000000000000000000007
7000000000000000000000000000000000000007
7000000000000000000000000000000000000007
7555555555555555550055555555555555555557
7555544444444444440044444444444444455557
7555544444444444440044444444444444455557
7555544444444444440044444444444444455557
7555544444444444440044444444444444455557
7555544444444444440044444444444444455557
7555544444444444440044444444444444455557
7555544444444444440044444444444444455557
7555544444444444440044444444444444455557
7555544444444444440044444444444444455557
7555544444444444440044444444444444455557
7555544444444444440044444444444444455557
7555544444444444440044444444444444455557
7555544444444444440044444444444444455557
7555544444444444440044444444444444455557
7555544444444444440044444444444444455557
7555544444444444440044444444444444455557
7555544444444444440044444444444444455557
7555544444444444440044444444444444455557
7555544444444444440044444444444444455557
7555544444444444440044444444444444455557
7555555555555555550055555555555555555557
7444000000000000000000000000000000004447
7444000000000000000000000000000000004447
7444000000000000000000000000000000004447
7777777777777777777777777777777777777777
